NO /home/ganeos/repos/42/4/cub3d/assets/textures/Stones_Texture.png
SO /home/ganeos/repos/42/4/cub3d/assets/textures/Brick_Texture.png
WE /home/ganeos/repos/42/4/cub3d/assets/textures/Brickwall6_Texture.png
EA /home/ganeos/repos/42/4/cub3d/assets/textures/Brickwall_Texture.png
F 220,100,0
C 225,30,0
1111111111111111111111111    1111111
1000000000110000000000001    1001111
1011000001110000000000001    1000001
100100000000000000000000111111000001
110000000000000000000000000000001001
100000000000000001110111111111111001
111101000000E00001000000100011111001
111101111111110111010100000000000001
110000001111010111000000000011111111
10000000000000001100000000001
10000000000000001100010010001
1000001111111111111011110001
11110111         100111010001
11111111         111111111111