NO /Users/manujime/repos/cursus/4/cub3d/assets/textures/bluestone.png
SO /Users/manujime/repos/cursus/4/cub3d/assets/textures/Brickwall3_Texture.png

WE         /Users/manujime/repos/cursus/4/cub3d/assets/textures/redbrick.png



EA /Users/manujime/repos/cursus/4/cub3d/assets/textures/colorstone.png



F 220,180,0



C       64,64,64



1111111111111111111111111    1111111
1000000000110000000000001    1001111
1011000001110000000000001    1000001
100100000000000000000000111111000001
110000000000000000000000000000000001
100000000000000001111111111111111001
111101000000N00001      100011111001
111101111111110111111111100000000001
110000001111010111000000000011111111
100000000000000011000000000011111111
10000000000000001101010010001
11000001111111111111011110001
11110111         100000000001
11111111         111111111111
