1111111111111111111111111    1111
1000000000110000000000001    1001111
1011000001110000000000001    1000001
100100000000000000000000111111000001
110000000000d00000000000000000000001
100000000000000001110111111111111001
111101000000E00001000000100011111001
111101111111110111010100000000000001
110000001111010111000000000011111111
10000000000000001100000000001
10000000000000001101010010001
11000001111111111111011110001
11110111         101111010001
11111111         111111111111
