1111111111111111111111111    1111
1000000000110000000000001    1001
1011000001110000000000001    1001
100100000000000000000000111111001
110000000000d0000000000000000001
100000000000000001110111111111111
111101000000E00001000000100011
11110111111111011101010000001
11000000111101011100000000001
10000000000000001100000000001
10000000000000001101010010001
11000001111111111111011110001
11110111         101111010001
11111111         111111111111
